10 11 11 11 13 11 11 11 13 11 11 11 10 11 11 11 10 
12 1 2 3 12 1 2 3 12 1 2 3 12 1 2 3 12 
12 4 5 6 13 4 5 6 12 4 5 6 12 4 5 6 12 
12 7 8 9 12 7 8 9 12 7 8 9 12 7 8 9 12 
13 11 11 11 13 11 11 11 13 11 11 11 10 11 11 11 10 
12 1 2 3 12 1 2 3 12 1 2 3 12 1 2 3 12 
12 4 5 6 12 4 5 6 12 4 5 6 12 4 5 6 12 
12 7 8 9 12 7 8 9 12 7 8 9 12 7 8 9 12 
10 11 11 11 10 11 13 11 13 11 11 13 10 11 11 11 10 
12 1 2 3 12 1 2 3 12 1 2 3 12 1 2 3 12 
12 4 5 6 12 4 5 6 12 4 5 6 12 4 5 6 12 
12 7 8 9 12 7 8 9 12 7 8 9 12 7 8 9 12 
13 11 11 11 13 11 11 11 13 11 11 11 10 11 11 11 10 
12 1 2 3 12 1 2 3 12 1 2 3 12 1 2 3 12 
12 4 5 6 12 4 5 6 12 4 5 6 12 4 5 6 12 
12 7 8 9 12 7 8 9 12 7 8 9 12 7 8 9 12 
10 11 11 11 10 11 11 11 10 11 11 11 10 11 11 11 10 
